11111111111111111111111111111111
1..............................1
1...1111................1111...1
1..............................1
1..............................1
1..............................1
1.............1.1..............1
1.............1.1..............1
1.........11111.11111..........1
1.......111.........111........1
1..............P...............1
1.......111.........111........1
1.........11111.11111..........1
1.............1.1..............1
1.............1.1..............1
1..............................1
1..............................1
1..............................1
1..............................1
1..............................1
1..............................1
1...1111................1111...1
1..............................1
11111111111111111111111111111111
#line 1 is row 0 and will be the y value of all